NO ./textures/north.xpm
SO ./textures/north.xpm
WE ./textures/north.xpm
EA ./textures/north.xpm

F 255,182,193
C 173,216,230

111111
100001
10W001
111111
